11111111111111111111
1P000000001000000001
100011000001111000C1
100011000000000000C1
10001111110000000001
10000000000000000001
10000000000000000001
10000000001111110001
10000000000000010001
10000000000000010001
11111000000000010001
1C000000001111100001
10000000000000000001
10000000000000000001
10000000001111111101
100000C0000000000001
10001111100000000001
1C0010000000010E0001
10000000000000000001
11111111111111111111