
10000000000000000000000000000C00000000000000000000000000000000001111111111111101
10000000000000000000000000000000000000000000000000000000000000001111111111111101
10000000000000000000000000000000000000000000000000000000000000001111111111111101
10000000000000000000000000000000010000000000000000000000000000001111111111111101
10000000000000000000000000000000000000000000000000000000000000001111111111111101
10000000000000000000000000000000000000000000000000000000000000001111111111111101
10000000000000000000000000000000000000000000000000000000000000001111111111111101
10000000000000000000000000000000000000000000000000000000000000001111111111111101
10000000000000000000000000000000000000000000000000000000000000001111111111111101
10000000000000000000000000000000000000000000000000000000000000001111111111111101
10000000000000000000000000000000000000000000000000000000000000001111111111111101
10000000000000000000000000000000000000000000000000000000000000001111111111111101
10000000000000000000000000000000000000000000000000000000000000001111111111111101
10000000000000000000000000000000000000000000000000000000000000001111111111111101
10000000000000000000000000000000000000000000000000000000000000001111111111111101
10000000000000000000000000000C00000000000000000000000000000000001111111111111101
10000000000000000000000000000000000000000000000000000000000000001111111111111101
10000000000000000000000000000000000000000000000000000000000000001111111111111101
100000000000000000000000000000000E0000000000000000000000000000001111111111111101
10000000000000000000000000000000000000000000000000000000000000001111111111111101
10000000000000000000000000000000000000000000000000000000000000001111111111111101
10000000000000000000000000000000000000000000000000000000000000001111111111111101
10000000000000000000000000000000000000000000000000000000000000001111111111111101
10000000000000000000000000000P00000000000000000000000000000000001111111111111101
10000000000000000000000000000000000000000000000000000000000000001111111111111101
10000000000000000000000000000000000000000000000000000000000000001111111111111101
10000000000000000000000000000000000000000000000000000000000000001111111111111101
10000000000000000000000000000000000000000000000000000000000000001111111111111101
10000000000000000000000000000000000000000000000000000000000000001111111111111101
10000000000000000000000000000000000000000000000000000000000000001111111111111101
10000000000000000000000000000000000000000000000000000000000000001111111111111101
11111111111111111111111111111111111111111111111111111111111111111111111111111111