111111111111111111
1P0000000001C000X1
111111100001000111
1000000000010000E1
100011111000000111
1000000C1C000000X1
1C11000000000000X1
111111111111111111