111111111111111111
1P000000C001000001
1C1111100000000CX1
100000000011111111
1C001C1110000C00X1
111000001000000011
1C0010000C001000E1
100000000C0X111111
111111111111111111