111111111111111
1P1001C000000X1
100001000000001
111000000000111
1000000000000E1
1C000001C0000X1
111111111111111